5*1
1
s000000000,T000090000,G000000000,G000000000,G000000000
G000000000,N000000000,R000180000,N000000000,G000000000
G000000000,S000270000,H000000000,N000000000,T000000000
G000000000,N000000000,H000000000,N000000000,G000000000
G000000000,G000000000,N000000000,N000000000,e000000000
T
 4, 0, 1:x
 3, 0, 2:O