3*3
1
G000000000,N000000000,e000000000
G000000000,N000000000,R000180000
s000000000,S000270000,H000000000
3
G000000000,G000000000,G000000000
G000000000,N000000000,G000000000
G000000000,G000000000,G000000000
5
H000000000,H000000000,H000000000
H000000000,N000000000,H000000000
H000000000,H000000000,H000000000
T
 0, 0, 0= 0, 2, 0
 2, 0, 2= 2, 4, 2
 2, 2, 0= 2, 4, 0
 0, 2, 2= 0, 4, 2
 2, 2, 2:x
 0, 4, 0:O