9*1
1
s000000000,N000000000,H000000000,N000000000,G000000000,N000000000,H000000000,N000000000,G000000000
G000000000,S000270000,H000000000,R000270000,G000000000,S000270000,H000000000,R000270000,G000000000
G000000000,N000000000,H000000000,N000000000,G000000000,N000000000,H000000000,N000000000,G000000000
G000000000,R000090000,H000000000,S000090000,G000000000,R000090000,H000000000,S000090000,G000000000
G000000000,N000000000,H000000000,N000000000,G000000000,N000000000,H000000000,N000000000,G000000000
G000000000,S000270000,H000000000,R000270000,G000000000,S000270000,H000000000,R000270000,G000000000
G000000000,N000000000,H000000000,N000000000,G000000000,N000000000,H000000000,N000000000,G000000000
G000000000,R000090000,H000000000,S000090000,G000000000,R000090000,H000000000,S000090000,G000000000
G000000000,N000000000,H000000000,N000000000,G000000000,N000000000,H000000000,N000000000,e000000000
T
 8, 0, 0= 0, 0, 6
 0, 0, 2= 8, 0, 6
 8, 0, 2= 0, 0, 4
 0, 0, 8= 8, 0, 4
 4, 0, 2:O
 4, 0, 6:x