5*3
1
N000000000,G000000000,S000270000,H000000000,G000000000
G000000000,N000000000,G000000000,H000000000,e000000000
G000000000,N000000000,G000000000,H000000000,H000000000
G000000000,N000000000,G000000000,N000000000,H000000000
N000000000,N000000000,N000000000,N000000000,H000000000
3
s000000000,G000000000,H000000000,N000000000,H000000000
G000000000,N000000000,H000000000,N000000000,S000180000
G000000000,N000000000,N000000000,R000270000,G000000000
G000000000,N000000000,G000000000,G000000000,G000000000
N000000000,H000000000,H000000000,H000000000,H000000000
T
 0, 0, 1= 0, 2, 1
 3, 0, 0= 3, 2, 0
 1, 0, 2= 1, 2, 2
 3, 0, 2= 3, 2, 2
 2, 0, 3= 2, 2, 3
 0, 0, 4= 0, 2, 4
 4, 0, 4= 4, 2, 4
 1, 0, 0:x
 0, 2, 2:x
 4, 2, 1:O