5*1
1
H000000000,H000000000,G000000000,R000090000,H000000000
G000000000,N000000000,e000000000,N000000000,S000180000
G000000000,H000000000,N000000000,G000000000,G000000000
G000000000,H000000000,H000000000,H000000000,T000000000
G000000000,G000000000,s000000000,G000000000,G000000000
T
 0, 0, 0= 2, 0, 3
 0, 0, 4= 3, 0, 3
 1, 0, 0= 2, 0, 1
 0, 0, 1:x
 4, 0, 4:O
