9*1
1
s000000000,G000000000,G000000000,N000000000,G000000000,G000000000,G000000000,G000000000
N000000000,G000000000,N000000000,N000000000,N000000000,G000000000,G000000000,G000000000
N000000000,N000000000,N000000000,N000000000,N000000000,N000000000,G000000000,N000000000
N000000000,N000000000,H000000000,N000000000,N000000000,N000000000,N000000000,N000000000
N000000000,N000000000,H000000000,N000000000,G000000000,G000000000,G000000000,G000000000
N000000000,N000000000,S000180000,N000000000,N000000000,N000000000,N000000000,S000000000
N000000000,G000000000,G000000000,N000000000,N000000000,H000000000,H000000000,H000000000
H000000000,N000000000,N000000000,N000000000,N000000000,R000000000,N000000000,N000000000
H000000000,R000270000,e000000000,N000000000,N000000000,G000000000,G000000000,N000000000
T
 0, 0, 2= 0, 0, 4
 1, 0, 1= 7, 0, 0
 0, 0, 7= 6, 0, 1
 1, 0, 7= 3, 0, 2
 1, 0, 5= 4, 0, 4
 2, 0, 6= 8, 0, 6
 6, 0, 2:x
 6, 0, 6:O