5*1
1
H000000000,N000000000,G000000000,G000000000,e000000000
H000000000,N000000000,N000000000,N000000000,N000000000
H000000000,N000000000,G000000000,G000000000,G000000000
N000000000,H000000000,G000000000,N000000000,G000000000
N000000000,N000000000,N000000000,N000000000,s000000000
T
 0, 0, 0= 0, 0, 2
 2, 0, 0= 3, 0, 2
 3, 0, 1= 2, 0, 2